NO ./images_xpm/text_NO.xpm

SO ./images_xpm/text_SO.xpm
WE ./images_xpm/text_WE.xpm

EA ./images_xpm/text_EA.xpm


F 0,0,0
C 255,255,255

11111111111111111111
10000000E00000000001
10011100000101110101
100010000000010000011
1010110001111101100011
10001000010001000100011
101111000111011101000011
1010000000000000010000011
10111000000000000000000011
100000000000010000000000011
101111000000011101000000011
100010000000010000000001011
100011000011110011000000011
100010000000010000000000011
10111100001101000000000011
1010000000000000010000011
101111100000001110000011
10000000000000000000011
1011110000000000000011
100000000000000000011
11111111111111111111